0004
11
14
0 0 0 0 0 0 0 0 0 0 0 0 0 0 
0 20 2 2 3 0 21 0 1 2 2 3 0 0 
0 0 4 5 6 0 4 2 5 5 15 6 0 0 
0 0 4 5 6 0 4 5 15 5 5 6 0 0 
0 0 4 5 6 0 4 5 5 5 15 6 0 0 
0 0 4 5 6 0 7 8 8 5 5 6 0 0 
0 0 4 15 6 0 0 0 0 4 15 6 0 0 
0 0 4 5 5 2 2 2 2 5 5 6 0 0 
0 0 4 5 5 5 5 15 5 5 5 6 0 0 
0 0 7 8 8 8 8 8 8 8 8 9 0 0 
0 0 0 0 0 0 0 0 0 0 0 0 0 0 
1
10 8 U U U U U U D D D D D D
2
2 6 U D
6 3 U D
1
7 7 U D
0