0006
9
22
0 0 0 0 0 0 0 0 0 0 0 0 0 0 0 0 0 0 0 0 0 0 
0 20 2 2 2 2 2 2 2 2 2 2 2 2 2 2 2 2 2 3 0 0 
0 0 4 5 5 5 15 5 5 5 5 5 5 5 5 5 5 5 15 6 0 0 
0 0 4 5 5 5 5 5 5 5 5 5 5 5 5 5 5 5 5 6 0 0 
0 0 4 15 5 5 5 5 5 15 5 5 5 5 5 15 5 5 5 6 0 0 
0 0 4 5 5 5 5 5 5 5 5 5 5 5 5 5 5 5 5 6 0 0 
0 0 4 5 5 5 5 5 5 5 5 5 15 5 5 5 5 5 5 6 0 0 
0 0 7 8 8 8 8 8 8 8 8 8 8 8 8 8 8 8 8 8 21 0 
0 0 0 0 0 0 0 0 0 0 0 0 0 0 0 0 0 0 0 0 0 0 
0
3
3 1 D D D D D D U U¡¡U U U U
6 7 U U U U U U D D D D D D
9 1 D D D D D D U U U U U U
3
12 7 U U U U U U D D D D D D
15 1 D D D D D D U U U U U U
18 7 U U U U U U D D D D D D
0