0002
9
16
0 0 0 0 0 0 0 0 0 0 0 0 0 0 0 0 
0 0 11 2 12 2 2 2 12 2 12 2 2 3 0 0 
0 0 4 5 5 5 5 5 5 5 5 5 5 6 0 0 
0 0 4 5 5 5 5 5 5 5 5 5 5 6 0 0 
0 20 5 5 5 5 5 5 5 5 5 5 5 5 21 0 
0 0 4 5 5 5 5 5 5 5 5 5 5 6 0 0 
0 0 4 5 5 5 5 5 5 5 5 5 5 6 0 0 
0 0 7 8 8 18 8 18 8 8 8 18 8 19 0 0 
0 0 0 0 0 0 0 0 0 0 0 0 0 0 0 0 
4
3 1 D D D D D U U U U U
6 7 U U U U U D D D D D
9 1 D D D D D U U U U U
12 7 U U U U U D D D D D
0
0
0