0001
12
12
0 0 0 0 0 0 0 0 0 0 0 0 
0 20 2 2 2 3 0 1 2 2 21 0 
0 0 4 5 5 6 0 4 5 6 0 0 
0 0 14 15 15 6 0 4 15 6 0 0 
0 0 4 5 5 6 0 4 15 6 0 0 
0 0 4 15 15 16 0 4 15 6 0 0 
0 0 4 5 5 6 0 4 15 6 0 0 
0 0 14 15 15 6 0 4 15 6 0 0 
0 0 4 5 5 6 0 4 5 6 0 0 
0 0 4 5 5 5 2 5 5 6 0 0 
0 0 7 8 8 8 8 8 8 9 0 0 
0 0 0 0 0 0 0 0 0 0 0 0 
3
5 3 L L L R R R
2 5 R R R L L L
5 7 L L L R R R
1
8 9 U U U U U U U D D D D D D D
0
0