0005
9
15
0 0 0 0 0 0 0 0 0 0 0 0 0 0 0 
0 20 2 2 3 0 1 2 2 2 2 2 3 0 0 
0 0 4 5 6 0 4 5 5 8 5 5 6 0 0 
0 0 4 15 6 0 4 15 6 0 4 15 6 0 0 
0 0 4 15 6 0 4 15 6 0 4 15 6 0 0 
0 0 4 15 6 0 4 15 6 0 4 15 6 0 0 
0 0 4 5 5 2 5 5 6 0 4 5 6 0 0 
0 0 7 8 8 8 8 8 9 0 7 8 8 21 0 
0 0 0 0 0 0 0 0 0 0 0 0 0 0 0 
0
2
3 2 U D D D D D D U U U U U
11 2 U D D D D D D U U U U U
3
3 6 D U U¡¡U U U U D D D D D
7 2 U D D D D D D U U U U U
11 6 D U U U U U U D D D D D
1
7 6 D U U U U U U D D D D D