0003
11
11
0 0 0 0 0 0 0 0 0 0 0 
0 0 1 2 2 12 2 2 3 0 0 
0 0 4 5 5 15 5 5 6 0 0 
0 0 4 5 5 15 5 5 6 0 0 
0 0 4 5 5 5 5 5 6 0 0 
0 20 5 5 5 5 5 5 5 21 0 
0 0 4 5 5 15 5 5 6 0 0 
0 0 4 5 5 15 5 5 6 0 0 
0 0 4 5 5 15 5 5 6 0 0 
0 0 7 8 8 8 8 8 9 0 0 
0 0 0 0 0 0 0 0 0 0 0 
0
2
5 4 U U U D D D D D D D D U U U U U
5 9 U U U U U U U U D D D D D D D D
0
0